1000110001
1000100011
1000000111
1000100011
1000110001